11 10
####E#####
#........#
#....#...#
#....#...#
#....#...#
#....#...#
#....#...#
#....#...#
#....#...#
#B...#.A.#
##########