10 10
##########
E.##.....#
#.##.###.#
#.##.#...#
#.##.#####
#........#
####.###.#
#....#...#
#A######B#
##########