13 14
#######E######
#...#.....#..#
#.###.#.#.##.#
#.#...#.#....#
#.#.#.########
#.#.#........#
#.#.########.#
#.#.....#.#..#
#.#####.#.#.##
#...#...#.#..#
###.#.###.##.#
#A....#..B...#
##############
